********************
*        2         *
*  111111111111    *
*  1111111111112   *
*  111111111111    *
*  1112    2111    *
*  111      111    *
*111112     111    *
*11111      1111111*
*11111     21111111*
*  2        1111111*
*                  *
********************